7 7 7 7 7 7 7 7 7 7 7 7 7 7 7 7 7 7 7 7 7 7 7 7 7 7 7 7 7 7 7 7 7 7 7 7 7 7 7 7 7 7 7 7 7 7 7 7 7 7 
7 7 7 7 7 7 7 7 7 20 20 20 20 20 20 20 20 20 20 20 20 20 20 20 20 20 20 20 20 20 20 20 20 20 20 20 20 20 20 20 20 7 7 7 7 7 7 7 7 7 
7 7 7 7 7 7 7 7 7 20 20 20 20 20 20 20 20 20 20 20 20 20 20 20 20 20 20 20 20 20 20 20 20 20 20 20 20 20 20 20 20 7 7 7 7 7 7 7 7 7 
7 7 7 7 7 7 7 7 7 20 20 20 20 20 20 20 20 20 20 20 20 20 20 20 20 20 20 20 20 20 20 20 20 20 20 20 20 20 20 20 20 7 7 7 7 7 7 7 7 7 
7 7 7 7 7 7 7 7 7 20 20 20 20 20 20 20 20 20 20 20 20 20 20 20 20 20 20 20 20 20 20 20 20 20 20 20 20 20 20 20 20 7 7 7 7 7 7 7 7 7 
7 7 7 7 7 7 7 7 7 20 20 20 20 20 20 20 20 20 20 20 20 20 20 20 20 20 20 20 20 20 20 20 20 20 20 20 20 20 20 20 20 7 7 7 7 7 7 7 7 7 
7 7 7 7 7 7 7 7 7 20 20 20 20 20 20 20 20 20 20 20 20 20 20 20 20 20 20 20 20 20 20 20 20 20 20 20 20 20 20 20 20 7 7 7 7 7 7 7 7 7 
7 7 7 7 7 7 7 7 7 20 20 20 20 20 20 20 20 20 20 20 20 20 20 20 20 20 20 20 20 20 20 20 20 20 20 20 20 20 20 20 20 7 7 7 7 7 7 7 7 7 
7 7 7 7 7 7 7 7 7 20 20 20 20 20 20 20 20 20 20 20 20 20 20 20 20 20 20 20 20 20 20 20 20 20 20 20 20 20 20 20 20 7 7 7 7 7 7 7 7 7 
7 7 7 7 7 7 7 7 7 20 20 20 20 20 20 20 20 20 20 20 20 20 20 20 20 20 20 20 20 20 20 20 20 20 20 20 20 20 20 20 20 7 7 7 7 7 7 7 7 7 
7 7 7 7 7 7 7 7 7 20 20 20 20 20 20 20 20 20 20 20 20 20 20 20 20 20 20 20 20 20 20 20 20 20 20 20 20 20 20 20 20 7 7 7 7 7 7 7 7 7 
7 7 7 7 7 7 7 7 7 20 20 20 20 20 20 20 20 20 20 20 20 20 20 20 20 20 20 20 20 20 20 20 20 20 20 20 20 20 20 20 20 7 7 7 7 7 7 7 7 7 
7 7 7 7 7 7 7 7 7 20 20 20 20 20 20 20 20 20 20 20 20 20 20 20 20 20 20 20 20 20 20 20 20 20 20 20 20 20 20 20 20 7 7 7 7 7 7 7 7 7 
7 7 7 7 7 7 7 7 7 20 20 20 20 20 20 20 20 20 20 20 20 20 20 20 20 20 20 20 20 20 20 20 20 20 20 20 20 20 20 20 20 7 7 7 7 7 7 7 7 7 
7 7 7 7 7 7 7 7 7 20 20 20 20 20 20 20 20 20 20 20 20 20 20 20 20 20 20 20 20 20 20 20 20 20 20 20 20 20 20 20 20 7 7 7 7 7 7 7 7 7 
7 7 7 7 7 7 7 7 7 20 20 20 20 20 20 20 20 20 20 20 20 20 20 20 20 20 20 20 20 20 20 20 20 20 20 20 20 20 20 20 20 7 7 7 7 7 7 7 7 7 
7 7 7 7 7 7 7 7 7 20 20 20 20 20 20 20 20 20 20 20 20 20 20 20 20 20 20 20 20 20 20 20 20 20 20 20 20 20 20 20 20 7 7 7 7 7 7 7 7 7 
7 7 7 7 7 7 7 7 7 20 20 20 20 20 20 20 20 20 20 20 20 20 20 20 20 20 20 20 20 20 20 20 20 20 20 20 20 20 20 20 20 7 7 7 7 7 7 7 7 7 
7 7 7 7 7 7 7 7 7 20 20 20 20 20 20 20 20 20 20 20 20 20 20 20 20 20 20 20 20 20 20 20 20 20 20 20 20 20 20 20 20 7 7 7 7 7 7 7 7 7 
7 7 7 7 7 7 7 7 7 20 20 20 20 20 20 20 20 20 20 20 20 20 20 20 20 20 20 20 20 20 20 20 20 20 20 20 20 20 20 20 20 7 7 7 7 7 7 7 7 7 
7 7 7 7 7 7 7 7 7 20 20 20 20 20 20 20 20 20 20 20 20 20 20 20 20 20 20 20 20 20 20 20 20 20 20 20 20 20 20 20 20 7 7 7 7 7 7 7 7 7 
7 7 7 7 7 7 7 7 7 7 7 7 7 7 7 7 7 7 7 7 7 7 7 7 20 20 20 20 20 7 7 7 7 7 7 7 7 7 7 7 7 7 7 7 7 7 7 7 7 7 
7 20 20 20 20 20 20 20 20 20 20 20 20 20 20 20 20 20 20 20 20 20 20 7 20 20 20 20 20 7 20 20 20 20 20 20 20 20 20 20 20 20 20 20 20 20 20 20 20 7 
7 20 20 20 20 20 20 20 20 20 20 20 20 20 20 20 20 20 20 20 20 20 20 7 20 20 20 20 20 7 20 20 20 20 20 20 20 20 20 20 20 20 20 20 20 20 20 20 20 7 
7 20 20 20 20 20 20 20 20 20 20 20 20 20 20 20 20 20 20 20 20 20 20 7 20 20 20 20 20 7 20 20 20 20 20 20 20 20 20 20 20 20 20 20 20 20 20 20 20 7 
7 20 20 20 20 20 20 20 20 20 20 20 20 20 20 20 20 20 20 20 20 20 20 7 20 20 20 20 20 7 20 20 20 20 20 20 20 20 20 20 20 20 2 20 20 20 20 20 20 7 
7 20 20 20 20 20 20 20 20 20 20 20 20 20 20 20 20 20 20 20 20 20 20 7 20 20 20 20 20 7 20 20 20 20 20 20 20 20 20 20 20 20 20 20 20 20 20 20 20 7 
7 20 20 20 20 20 20 20 20 20 20 20 20 20 20 20 20 20 20 20 20 20 20 20 20 20 20 20 20 20 20 20 20 20 20 20 20 20 20 20 20 20 20 20 20 20 20 20 20 7 
7 7 7 7 7 7 7 7 7 7 7 7 7 7 7 7 7 7 7 7 7 7 7 7 20 20 20 20 20 7 7 7 7 7 7 7 7 7 7 7 7 7 7 7 7 7 7 7 7 7 
7 7 7 7 7 7 7 7 7 7 7 7 7 7 7 7 7 7 7 7 7 7 7 7 7 20 20 20 7 7 7 7 7 7 7 7 7 7 7 7 7 7 7 7 7 7 7 7 7 7 
7 7 7 7 7 7 7 7 7 7 7 7 7 7 7 7 7 7 7 7 7 7 7 7 7 7 20 7 7 7 7 7 7 7 7 7 7 7 7 7 7 7 7 7 7 7 7 7 7 7 
7 7 7 7 7 7 7 7 7 7 7 7 7 7 7 7 7 7 7 7 7 7 7 7 7 7 20 7 7 7 7 7 7 7 7 7 7 7 7 7 7 7 7 7 7 7 7 7 7 7 
7 7 7 7 7 7 7 7 7 7 7 7 7 7 7 7 7 7 7 7 7 7 7 7 7 7 20 7 7 7 7 7 7 7 7 7 7 7 7 7 7 7 7 7 7 7 7 7 7 7 
7 20 20 20 20 20 20 20 20 20 20 20 20 20 20 20 7 7 7 7 7 7 7 7 7 7 20 7 7 7 7 7 7 7 7 7 7 20 20 20 20 20 20 20 20 20 20 20 20 7 
7 20 20 20 20 20 20 20 20 20 20 20 20 20 20 20 20 7 7 7 7 7 7 7 7 7 20 7 7 7 7 7 7 7 7 7 20 20 20 20 20 20 20 20 20 20 20 20 20 7 
7 20 20 20 20 20 20 20 20 20 20 20 20 20 20 20 20 20 7 7 7 7 7 7 7 7 20 7 7 7 7 7 7 7 7 20 20 20 20 20 20 20 20 20 20 20 20 20 20 7 
7 20 20 20 20 20 20 20 20 20 20 20 20 20 20 20 20 20 20 7 7 7 7 7 7 7 20 7 7 7 7 7 7 7 20 20 20 20 20 20 20 20 20 20 20 20 20 20 20 7 
7 20 20 20 20 20 20 20 20 20 20 20 20 20 20 20 20 20 20 20 7 7 7 7 7 7 20 7 7 7 7 7 7 20 20 20 20 20 20 20 20 20 20 20 20 20 20 20 20 7 
7 20 20 20 20 20 20 20 20 20 20 20 20 20 20 20 20 20 20 20 20 20 20 20 20 20 20 20 20 20 20 20 20 20 20 20 20 20 20 20 20 20 20 20 20 20 20 20 20 7 
7 20 20 20 20 20 20 20 20 20 20 20 20 20 20 20 20 20 20 20 7 7 7 7 7 7 20 7 7 7 7 7 7 20 20 20 20 20 20 20 20 20 20 20 20 20 20 20 20 7 
7 20 20 20 20 20 20 20 20 20 20 20 20 20 20 20 20 20 20 7 7 7 7 7 7 7 20 7 7 7 7 7 7 7 20 20 20 20 20 20 20 20 20 20 20 20 20 20 20 7 
7 20 20 20 20 20 20 20 20 20 20 20 20 20 20 20 20 20 7 7 7 7 7 7 7 7 20 7 7 7 7 7 7 7 7 20 20 20 20 20 20 20 20 20 20 20 20 20 20 7 
7 7 7 7 7 7 7 7 7 7 7 7 7 7 7 7 7 7 7 7 7 7 7 7 7 20 20 20 7 7 7 7 7 7 7 7 7 7 7 7 7 7 7 7 7 7 7 7 7 7 
7 7 7 7 7 7 7 7 7 7 7 7 7 7 7 7 7 7 7 7 7 7 7 7 20 20 20 20 20 7 7 7 7 7 7 7 7 7 7 7 7 7 7 7 7 7 7 7 7 7 
7 7 7 7 7 7 7 7 7 7 7 7 7 7 7 7 7 7 7 7 7 7 7 20 20 20 20 20 20 20 7 7 7 7 7 7 7 7 7 7 7 7 7 7 7 7 7 7 7 7 
7 7 7 7 7 7 7 7 7 7 7 7 7 7 7 7 7 7 7 7 7 7 20 20 20 20 20 20 20 20 20 7 7 7 7 7 7 7 7 7 7 7 7 7 7 7 7 7 7 7 
7 7 7 7 7 7 7 7 7 7 7 7 7 7 7 7 7 7 7 7 7 20 20 20 20 20 20 20 20 20 20 20 7 7 7 7 7 7 7 7 7 7 7 7 7 7 7 7 7 7 
7 7 7 7 7 7 7 7 7 7 7 7 7 7 7 7 7 7 7 7 20 20 20 20 20 20 20 20 20 20 20 20 20 7 7 7 7 7 7 7 7 7 7 7 7 7 7 7 7 7 
7 7 7 7 7 7 7 7 7 7 7 7 7 7 7 7 7 7 7 20 20 20 20 20 20 20 20 20 20 20 20 20 20 20 7 7 7 7 7 7 7 7 7 7 7 7 7 7 7 7 
7 7 7 7 7 7 7 7 7 7 7 7 7 7 7 7 7 7 7 7 7 7 7 7 7 7 1 7 7 7 7 7 7 7 7 7 7 7 7 7 7 7 7 7 7 7 7 7 7 7 
